.#.@#*.@@
**#.@@*..
*#.@@#*#@
..*.##@*.
**#@.@*@#
**@..@@*#
..#@@#*..
.**@@##@#
##@#*..*#