.........
**#.@@*..
*#.@@#*#@
..*.##@*.
**#..***#
**#..@@*#
.*#@@#*..
.**@@##@#
##@#*..*#