.@@.**.@.
**#.@@*..
*#.@@#*#@
..*.##@*.
**#*.*#@#
*@*..@@*#
.*#@@#*..
.**@@##@#
##@#*..*#