#**..*@@#
**#.@@*..
*#.@@#*#@
..*.##@*.
**#*.@.##
*#@..@@*#
.*#@@#*..
.**@@##@#
##@#*..*#