@..##*##@
**#.@@*..
*#.@@#*#@
..*.##@*.
**#@.@#.#
**#..@@*#
.@#@@#*..
.**@@##@#
##@#*..*#