.*.@#*.@@
**#.@@*..
*#.@@#*#@
..*.##@*.
**#*.@..#
*.#@.@@*.
#**.@#@@#
@..##@..@
.**#..@@.