...@#*.@@
**#.@@*..
*#.@@#*#@
..*.##@*.
**#..@@*#
**#..@@*#
#########
@@..@@..@
..@@..@@.