...@#*.@@#.
**#.@@*..**
*#.@@#*#@@#
..*.##@*.*#
**#..@@*#@.
**#..@@*#..
.*#@@#*..#*
.**@@##@#*.
##@#*..*#.@
.**##@@*.@@
.**##@..@*#