...@#*.@@
**#.@@*..
*#.@@#*#@
..*.##@*.
**#..@@*#
**#..@@*#
.*#@@#*..
.**@@##@#
##@#*..*#